[SETTINGS]
#cell_size	num_col_cells	num_row_cells
192	8	2
[OBJECTS]
#index_col	index_row	object_id
0	0	14	35
0	1	6	7	8	9	11	12	13	15	16	17	27	28	29
1	0	29
1	1	12	13	15	16	17	25	26
2	0	6	7	8	9
2	1	5	12	13	15	16	17	24	25
3	0	6	7	8	9
3	1	4	5	12	13	15	16	17	23	24
4	0
4	1	3	4	12	13	15	16	17	22	23
5	0
5	1	1	2	3	12	13	15	16	17	21	22
6	0
6	1	1	2	12	13	15	16	17	20	21
7	0
7	1	0	1	12	13	15	16	17	18	19	20
