27 30 31 32 32 33 34 31 35 27 
27 30 36 32 33 37 38 36 39 27 
27 39 40 41 42 43 44 36 39 27 
27 39 31 45 32 32 46 40 39 27 
27 47 36 44 32 33 37 48 39 27 
27 49 40 50 41 51 43 52 39 27 
