0 1 2 3 4 2 1 4 3 4 1 3 4 4 1 5 
6 7 8 9 10 11 12 4 9 1 12 9 10 1 12 5 
13 8 1 14 15 12 16 16 14 7 4 14 15 17 4 5 
0 4 18 3 5 4 4 5 0 19 10 5 2 10 20 5 
0 1 2 9 5 4 1 5 0 4 15 5 8 21 22 5 
0 23 8 9 5 4 12 5 24 4 4 4 25 26 9 5
